-42 -45 -49 -51 -54 -56 -58 -58 -58 -62 -63 -63 -65 -64 -64 -66 -67 -65
-35 -44 -49 -54 -55 -57 -59 -60 -60 -61 -62 -64 -62 -63 -65 -64 -66 -65
-44 -48 -50 -53 -57 -57 -58 -60 -60 -61 -62 -62 -63 -65 -65 -66 -64 -65
-44 -49 -52 -55 -56 -60 -58 -61 -61 -63 -63 -63 -64 -63 -64 -65 -65 -64
-43 -46 -50 -54 -57 -59 -59 -60 -60 -60 -62 -64 -62 -62 -63 -64 -63 -64
-44 -45 -54 -53 -56 -55 -57 -57 -59 -58 -59 -60 -62 -63 -65 -64 -63 -63
-47 -47 -50 -52 -53 -56 -57 -59 -59 -60 -60 -61 -61 -63 -63 -62 -63 -64
-52 -52 -51 -51 -53 -56 -58 -58 -58 -60 -59 -61 -62 -63 -60 -64 -62 -63
-56 -54 -53 -54 -56 -54 -55 -60 -59 -58 -58 -61 -61 -60 -63 -60 -64 -63
-54 -56 -57 -58 -58 -58 -57 -58 -61 -60 -59 -60 -61 -61 -61 -62 -65 -64
-57 -56 -57 -57 -58 -59 -60 -59 -59 -62 -61 -61 -62 -62 -64 -65 -65 -67
-55 -56 -55 -58 -59 -59 -61 -61 -62 -63 -63 -64 -64 -63 -66 -64 -63 -63
-57 -55 -57 -57 -61 -60 -61 -62 -63 -62 -63 -65 -63 -64 -66 -67 -67 -66
-60 -58 -59 -57 -61 -61 -61 -61 -63 -65 -63 -64 -67 -65 -65 -66 -66 -66
-61 -62 -61 -59 -61 -60 -61 -61 -62 -63 -62 -63 -62 -64 -66 -66 -64 -65
-58 -61 -61 -61 -63 -63 -62 -61 -64 -63 -62 -63 -66 -65 -63 -65 -66 -65
-61 -61 -60 -61 -59 -62 -63 -61 -63 -64 -64 -64 -66 -66 -65 -64 -65 -66
-62 -63 -63 -62 -61 -62 -62 -64 -62 -65 -65 -65 -63 -66 -67 -65 -66 -67