-56 -58 -56 -55 -54 -59 -59 -62 -53 -54 -55 -57 -62 -63 -58 -55 -59 -58
-56 -60 -55 -57 -55 -55 -62 -59 -51 -51 -51 -55 -56 -58 -58 -56 -57 -57
-52 -57 -58 -55 -56 -53 -55 -57 -51 -50 -49 -53 -58 -59 -55 -54 -57 -57
-55 -59 -56 -54 -52 -50 -57 -58 -50 -48 -50 -53 -56 -53 -56 -53 -58 -57
-59 -58 -53 -50 -53 -47 -47 -51 -55 -51 -52 -52 -56 -53 -57 -60 -60 -63
-61 -58 -60 -55 -53 -47 -46 -46 -53 -48 -53 -51 -50 -52 -57 -61 -61 -62
-61 -62 -60 -55 -54 -49 -45 -43 -49 -46 -46 -47 -50 -57 -58 -64 -62 -61
-60 -60 -60 -55 -54 -51 -44 -42 -47 -41 -45 -51 -54 -60 -61 -64 -63 -61
-62 -58 -60 -58 -53 -51 -51 -53 -43 -48 -53 -57 -60 -62 -59 -64 -65 -62
-60 -61 -59 -63 -61 -59 -60 -49 -47 -52 -55 -57 -59 -61 -59 -62 -64 -64
-66 -58 -59 -64 -60 -58 -56 -52 -47 -54 -50 -53 -57 -58 -58 -65 -64 -64
-64 -64 -60 -63 -58 -58 -57 -52 -58 -54 -48 -51 -55 -58 -62 -65 -64 -65
-62 -64 -62 -62 -61 -62 -55 -57 -61 -56 -57 -47 -48 -55 -58 -57 -64 -63
-64 -61 -64 -60 -57 -58 -57 -58 -61 -58 -60 -55 -51 -55 -57 -60 -63 -64
-61 -64 -63 -62 -61 -61 -61 -60 -64 -60 -62 -59 -55 -57 -58 -61 -62 -64
-68 -66 -67 -58 -60 -63 -60 -66 -62 -59 -63 -63 -56 -52 -54 -63 -63 -61
-70 -63 -63 -63 -65 -64 -61 -67 -58 -60 -62 -64 -58 -60 -61 -60 -60 -61
-65 -64 -65 -65 -63 -66 -65 -61 -63 -65 -63 -61 -60 -62 -60 -59 -61 -63
