-71 -70 -66 -66 -66 -66 -60 -66 -62 -63 -62 -61 -65 -65 -70 -67 -65 -69
-70 -69 -68 -67 -62 -61 -63 -62 -65 -65 -59 -61 -65 -68 -67 -65 -68 -64
-68 -71 -64 -65 -61 -68 -65 -63 -67 -65 -62 -65 -65 -66 -66 -61 -65 -71
-64 -67 -67 -63 -62 -65 -57 -62 -64 -59 -63 -64 -67 -60 -63 -63 -69 -67
-67 -67 -67 -66 -63 -65 -63 -63 -60 -60 -60 -60 -67 -66 -64 -67 -63 -67
-68 -69 -63 -64 -63 -65 -61 -61 -61 -55 -60 -59 -62 -58 -64 -67 -64 -68
-69 -70 -67 -61 -64 -63 -58 -56 -53 -52 -57 -58 -63 -62 -62 -69 -72 -68
-69 -67 -70 -61 -66 -65 -61 -55 -48 -48 -56 -60 -66 -67 -67 -69 -67 -68
-67 -66 -69 -63 -63 -66 -58 -54 -39 -41 -55 -62 -57 -67 -63 -69 -68 -71
-69 -69 -68 -69 -66 -66 -60 -52 -38 -38 -55 -64 -62 -62 -65 -63 -69 -66
-69 -69 -65 -64 -64 -62 -60 -58 -48 -46 -61 -60 -61 -62 -65 -65 -62 -70
-70 -71 -69 -69 -66 -66 -61 -57 -54 -57 -59 -62 -66 -67 -64 -60 -64 -68
-67 -70 -69 -69 -67 -60 -63 -64 -57 -59 -57 -66 -61 -60 -64 -66 -68 -69
-70 -71 -69 -67 -66 -65 -65 -62 -66 -66 -66 -65 -63 -63 -62 -66 -66 -67
-71 -73 -69 -66 -64 -64 -65 -62 -65 -59 -62 -58 -68 -69 -69 -72 -69 -67
-72 -68 -70 -69 -64 -68 -67 -65 -64 -64 -67 -63 -70 -66 -65 -64 -66 -71
-70 -69 -71 -69 -68 -65 -69 -67 -65 -62 -65 -68 -68 -66 -67 -69 -73 -64
-68 -73 -73 -69 -63 -68 -65 -65 -64 -64 -64 -66 -64 -66 -64 -64 -71 -69